$_$_$_$_$_$_$_$_$_$_$_$_
_$_$_$_$_$_$_$_$_$_$_T_$
$_$_$_$_$##_$_$_$_$##_$_
_$_#_$_$_$#$_$_$_$_$##_$
$_$_$_$_$_$_$_$_$_##$_$_
##_$_$$$$$$$$$$$$$_$_$##
B#$_$$$$$$##$$$$$_$_$_#B
B#_$_$$$$$$$$$$$$$_$_$#B
##$_$$$$$$$$$$$$#$$_$_##
_$_$_$$$$$$$$$$$$$_$_$_$
$_$_$###$_##$_$_$_$_$_$_
_$_$_$_$#####$_$_$_##$_$
$_A_$_$_$_$_$_$_$_$##_$_
_$_$_$_$_$_$_$_$_$_$_$_$