$$$$$$$$$$$$$$$$$$$$$$$$
$$$$$$$$$$$$$$$$$$$$$T$$
$$$$$$$$$##$$$$$$$$##$$$
$$$#$$$$$$#$$$$$$$$$##$$
$$$$$$$$$$$$$$$$$$##$$$$
##$$$$$$$$$$$$$$$$$$$$##
B#$$$$$$$$##$$$$$$$$$$#B
B#$$$$$$$$$$$$$$$$$$$$#B
##$$$$$$$$$$$$$$#$$$$$##
$$$$$$$$$$$$$$$$$$$$$$$$
$$$$$###$$##$$$$$$$$$$$$
$$$$$$$$#####$$$$$$##$$$
$$A$$$$$$$$$$$$$$$$##$$$
$$$$$$$$$$$$$$$$$$$$$$$$