$_$_$_$_$_$_$_$_$_$_$_$_
_$_$_T_$___$####_$___$_$
$_$$$$$$$##$$$$$$$$##_$_
$$$#$$$________$$$$$##$$
$_$$_$$_######_$_$##$_$_
##$$_$$_#____#_$_$_$$$##
B#$_$$__#_##_#_$$$$$$_#B
B#_$_$$_#_##_#_$$$_$$$#B
##$_$_$_#____#__#_$_$_##
_$_$_$__######_$$$$_$$$_
$__$$##________$$_$_$_$_
_$$$$$##$$$$##$$$$$##$$_
$___$##$$_$$##$A$$$##_$$
_$_$_$_$_$_$##_$_$_$_$__