_____B___BB__BBBB__$$$__
_____B__B__B_B____$$$$$_
_____B__B__B_BBBB__$$$__
_B___B__B__B_B__________
__BBB____BB__BBBB___T___
________________________
___##__##___#__##__#_#__
__#__#_#_#_#_#_#_#_#_#__
__#____##__###_##__###__
__#_##_#_#_#_#_#___#_#__
__#__#_#_#_#_#_#___#_#__
_A_##__#_#_#_#_#___#_#__
________________________
________________________