A$$$##$$$$$$$###$$##$#$$
##$$#######$$$$$$$$#$$$$
##$$$$$$$$#$$$###_$$$$$#
$$$$$$$#__##____#_$#$$$#
##$$$$$#___$____#___$$##
$#$____##########_$$_##$
$###___#$$$$$$__#_$__#$$
$$$#_$_#$$$$_#___$$_##_$
$$_____#_$$$$########_$$
$#######__#__$_#__###__$
$$$__#$$$_#____#___$$$_$
###__#$$###__$_#__####$$
__$$$##_$$#$$_##$$#$$$$$
_$$###$$#$$$$__$$##$$$_T