T___$_____$____$_______$
______$____________$____
_$___________#_______$__
____$_____$____$________
______$__________$_____$
___#_______$___$_#___$__
____$___________________
___________$_______$____
$_____$_______$____#___$
_______#________________
___$_______$____$___$___
$______$____#____$______
__________$____$______$_
____$________$_________A