T_##_______##_______##__
__##_______##_______##__
__$$__$_______$_____$$__
__$$______$______$__$$__
__##___$_______$____##__
__##_______$________##__
__$$___$_______$____$$__
__$$________$_______$$__
__##__$__________$__##__
__##_______$________##__
__$$____________$___$$__
__$$_____$__________$$__
__##_______##_______##__
__##_______##_______##_A